"filename", "language", "Go", "JSON", "comment", "blank", "total"
"/Users/chisato/go/src/bfw/common/adt/adt.go", "Go", 17, 0, 3, 4, 24
"/Users/chisato/go/src/bfw/common/adt/adt_test.go", "Go", 25, 0, 9, 4, 38
"/Users/chisato/go/src/bfw/common/adt/list.go", "Go", 348, 0, 45, 56, 449
"/Users/chisato/go/src/bfw/common/adt/priority_queue.go", "Go", 17, 0, 0, 9, 26
"/Users/chisato/go/src/bfw/common/adt/queue.go", "Go", 47, 0, 1, 11, 59
"/Users/chisato/go/src/bfw/common/adt/stack.go", "Go", 40, 0, 1, 10, 51
"/Users/chisato/go/src/bfw/common/fft/fft.go", "Go", 1, 0, 0, 1, 2
"/Users/chisato/go/src/bfw/common/la/matrix_poly.go", "Go", 8, 0, 0, 3, 11
"/Users/chisato/go/src/bfw/common/la/poly.go", "Go", 39, 0, 3, 2, 44
"/Users/chisato/go/src/bfw/common/la/poly_test.go", "Go", 0, 0, 6, 2, 8
"/Users/chisato/go/src/bfw/common/la/vector_v2.go", "Go", 1, 0, 0, 1, 2
"/Users/chisato/go/src/bfw/common/lang/array.go", "Go", 71, 0, 0, 12, 83
"/Users/chisato/go/src/bfw/common/lang/big_num.go", "Go", 13, 0, 0, 6, 19
"/Users/chisato/go/src/bfw/common/lang/complex128.go", "Go", 78, 0, 0, 11, 89
"/Users/chisato/go/src/bfw/common/lang/io.go", "Go", 43, 0, 15, 10, 68
"/Users/chisato/go/src/bfw/common/lang/io_test.go", "Go", 9, 0, 0, 3, 12
"/Users/chisato/go/src/bfw/common/lang/num.go", "Go", 256, 0, 8, 24, 288
"/Users/chisato/go/src/bfw/common/lang/num_test.go", "Go", 15, 0, 1, 5, 21
"/Users/chisato/go/src/bfw/common/lang/string.go", "Go", 82, 0, 5, 10, 97
"/Users/chisato/go/src/bfw/common/reflect/genfunc.json", "JSON", 0, 7, 0, 1, 8
"/Users/chisato/go/src/bfw/common/reflect/genfunc_by_struct.go", "Go", 1, 0, 0, 1, 2
"/Users/chisato/go/src/bfw/common/reflect/reflect_struct.go", "Go", 4, 0, 0, 2, 6
"/Users/chisato/go/src/bfw/common/reflect/struct_name.go", "Go", 94, 0, 9, 22, 125
"/Users/chisato/go/src/bfw/common/sql/phrase_v1.go", "Go", 212, 0, 8, 30, 250
"/Users/chisato/go/src/bfw/common/sql/phrase_v2.go", "Go", 193, 0, 32, 49, 274
"/Users/chisato/go/src/bfw/common/type_ref/type_ref.go", "Go", 182, 0, 1, 14, 197
"/Users/chisato/go/src/bfw/common/utils/db.go", "Go", 423, 0, 46, 53, 522
"/Users/chisato/go/src/bfw/common/utils/str.go", "Go", 59, 0, 5, 7, 71
"/Users/chisato/go/src/bfw/common/utils/web.go", "Go", 141, 0, 30, 30, 201
"/Users/chisato/go/src/bfw/common/workpool/concurrent.go", "Go", 72, 0, 0, 16, 88
"/Users/chisato/go/src/bfw/common/workpool/workpool.go", "Go", 91, 0, 1, 27, 119
"Total", "-", 2582, 7, 229, 436, 3254